@--#--###--#-
-#---#----##-
####-#-#-#-##
---#---#-#---
-#-####---##-
-#------#----
-############
-------------
